####################
####     ###########
####     ### #######
####     ###   #####
####     ###    ####
####             ###
###               ##
##                ##
##                ##
###              ###
##               ###
####            ####
####            ####
###              ###
##                ##
####            ####
###      ##     ####
###########***######