####################
################# ##
1     # ## ###### ##
1                 ##
###              ###
###               ##
###               ##
##               ###
###             ####
####            ####
###              *##
####       ##    ###
##         ##    ###
##  #             ##
## ##             ##
## ###  #         ##
## ########  #  ####
####################