####################
#################*##
      # ##*###### ##
        #         ##
###              ###
###               ##
###               ##
##               ###
###             ####
####            ####
###              *##
####             ###
##               ###
##  #             ##
## ##            *##
## ###  #         ##
##*########  #  ####
####################