###########   ######
#########     ######
######         #####
#####          #####
####            ####
#####             ##
#####             ##
#####     #        #
#####     #     ####
#####     #     ####
#####     #       ##
###                #
##                  
####                
####      #         
####      #     ####
######    ##########
####################